D-----PPPP-PP--
P-----P--PPP---
PPPPPPP--P-----
P--------PPPP--
PPPPPPPPPPP-P--
------P---PPP--
---PPPP--PPP----
---P-PP--P-----
---P-----PPPPP-
---PPPP------P-
--P-PP-PPPPPPP-
--P-P--PP----PP
--P-P---P-----P
--P-P---PPPP--P
--PPPP-----PPPA